cda : application-x-cdf
ogg : audio-ogg
wma : audio-x-ms-wma
deb : application-x-debian-package
rar : application-rar
rpm : application-x-redhat-package-manager
dmg : application-x-apple-diskimage
iso : application-x-iso9660-image
vcd : application-x-cdlink
mdb : application-msaccess
sql : application-x-sql
vcf : text-vcard
apk : application-vnd.android.package-archive
bat : application-x-msdos-program
com : application-x-msdos-program
exe : application-x-msdos-program
jar : application-java-archive
msi : application-x-msi
otf : font-ttf
ttf : font-ttf
bmp : image-x-ms-bmp
ico : image-vnd.microsoft.icon
psd : image-x-photoshop
cer : chemical-x-cerius
rss : application-x-rss+xml
pl : text-x-perl
class : application-java-vm
sh : text-x-sh
xlsm : application-vnd.ms-excel.sheet.macroEnabled.12
cab : application-x-cab
dll : application-x-msdos-program
3gp : video-3gpp
mov : video-quicktime
mpg : video-mpeg
mpeg : video-mpeg
rm : audio-x-pn-realaudio
